1234500000000
0000005432100
0000000000000
0000000000000
0000000000000
0000000000000
0000000000000
0000000000000
0000000000000
0102030405030
0000000000000
1020304050301
0000000000000